id,num_prompt_tokens,num_input_tokens,effective_num_gist_tokens,gist_index,first_run,model,cpu_time,cuda_time,flops
0,58,34,24,0,standard,standard,60083,18971,768285567292
0,58,34,24,0,standard,gist,98333,18908,450374408236
1,30,2,28,0,gist,standard,65345,19884,396947951300
1,30,2,28,0,gist,gist,62489,18523,26463445244
2,67,23,44,0,gist,standard,63658,24410,887819016280
2,67,23,44,0,gist,gist,62839,20577,304773867000
3,50,9,41,0,gist,standard,60440,20331,662105055340
3,50,9,41,0,gist,gist,64048,19246,119179128278
4,37,2,35,0,standard,standard,60247,20216,489705134140
4,37,2,35,0,standard,gist,67021,18766,26470799640
5,25,11,14,0,standard,standard,62501,19629,330724339540
5,25,11,14,0,standard,gist,69239,19204,145518858492
6,29,12,17,0,standard,standard,59578,20033,383701127692
6,29,12,17,0,standard,gist,67956,19348,158773036496
7,138,116,22,0,gist,standard,65862,32182,1833788897372
7,138,116,22,0,gist,gist,63376,29236,1541445782264
8,29,9,20,0,gist,standard,64878,20023,383701127692
8,29,9,20,0,gist,gist,63486,19178,119079843932
9,33,11,22,0,gist,standard,64309,20074,436694725892
9,33,11,22,0,gist,gist,63502,19335,145565086124
10,19,2,17,0,standard,standard,60778,19359,251290676152
10,19,2,17,0,standard,gist,68852,18401,26451888336
11,47,30,17,0,gist,standard,65050,20676,622304698720
11,47,30,17,0,gist,gist,61612,20970,397215861440
12,46,7,39,0,gist,standard,59776,20459,609040014436
12,46,7,39,0,gist,gist,63771,19015,92680227922
13,152,132,20,0,standard,standard,61450,32078,2020943293360
13,152,132,20,0,standard,gist,69721,32770,1755029737160
14,25,2,23,0,standard,standard,58884,19612,330724339540
14,25,2,23,0,standard,gist,63838,18424,26458192104
15,29,2,27,0,standard,standard,61160,20028,383701127692
15,29,2,27,0,standard,gist,62759,18408,26462394616
16,25,8,17,0,standard,standard,63243,19613,330724339540
16,25,8,17,0,standard,gist,64205,19079,105831969696
17,70,27,43,0,gist,standard,59763,24159,927682410580
17,70,27,43,0,gist,gist,63973,20804,357820521914
18,19,2,17,0,standard,standard,61121,19365,251290676152
18,19,2,17,0,standard,gist,68503,18409,26451888336
19,136,111,25,0,standard,standard,58906,31892,1807069365136
19,136,111,25,0,standard,gist,64663,28874,1474887545486
20,43,26,17,0,gist,standard,59608,20494,569252265352
20,43,26,17,0,gist,gist,65767,20574,344199149424
21,88,78,10,0,standard,standard,60342,26961,1167061345072
21,88,78,10,0,standard,gist,69050,25107,1034440767932
22,54,15,39,0,standard,standard,59266,20294,715186906292
22,54,15,39,0,standard,gist,69872,19564,198663221810
23,48,32,16,0,standard,standard,60881,20363,635570433632
23,48,32,16,0,standard,gist,67667,20812,423713711168
24,78,15,63,0,standard,standard,60856,24290,1034031023012
24,78,15,63,0,standard,gist,72123,19678,198852334850
25,42,7,35,0,gist,standard,63616,20362,555991783580
25,42,7,35,0,gist,gist,64154,18992,92665519130
26,53,30,23,0,standard,standard,60919,20420,701914867612
26,53,30,23,0,standard,gist,67573,21006,397310417960
27,29,2,27,0,gist,standard,62666,20052,383701127692
27,29,2,27,0,gist,gist,63651,18421,26462394616
28,52,33,19,0,gist,standard,63165,20189,688643879560
28,52,33,19,0,gist,gist,64034,20748,437024097770
29,104,74,30,0,standard,standard,60490,27450,1380128390992
29,104,74,30,0,standard,gist,69226,25138,982014508852
30,34,19,15,0,gist,standard,64125,19882,449945752012
30,34,19,15,0,gist,gist,62388,19965,251440390642
31,44,25,19,0,standard,standard,60941,20421,582513797752
31,44,25,19,0,standard,gist,69819,20265,330973863690
32,47,13,34,0,standard,standard,59102,20705,622304698720
32,47,13,34,0,standard,gist,68881,19577,172127024160
33,51,14,37,0,gist,standard,64588,18167,675373942136
33,51,14,37,0,gist,gist,63967,17594,185396961584
34,42,24,18,0,gist,standard,60756,20329,555991783580
34,42,24,18,0,gist,gist,63861,20231,317709704720
35,206,192,14,0,gist,standard,72371,39678,2744753488036
35,206,192,14,0,gist,gist,65685,34921,2558216861312
36,33,16,17,0,standard,standard,60824,20086,436694725892
36,33,16,17,0,standard,gist,68119,20024,211730913344
37,182,160,22,0,standard,standard,63352,33464,2422681842100
37,182,160,22,0,standard,gist,69431,33916,2129830223040
38,54,27,27,0,gist,standard,64321,20240,715186906292
38,54,27,27,0,gist,gist,63950,20607,357593586266
39,38,10,28,0,standard,standard,60585,20059,502960362772
39,38,10,28,0,standard,gist,70271,19201,132358186380
40,57,41,16,0,standard,standard,60440,20766,755009326100
40,57,41,16,0,standard,gist,63197,21357,543076958420
41,61,38,23,0,standard,standard,61237,20671,808120594636
41,61,38,23,0,standard,gist,69249,21098,503419487208
42,115,84,31,0,standard,standard,62284,28096,1526768003320
42,115,84,31,0,standard,gist,71650,28286,1115204526368
43,25,9,16,0,gist,standard,65154,19612,330724339540
43,25,9,16,0,gist,gist,64023,19163,119060932628
44,26,2,24,0,standard,standard,66424,19501,343966960636
44,26,2,24,0,standard,gist,69265,18444,26459242732
45,31,2,29,0,gist,standard,62485,20136,410195825536
45,31,2,29,0,gist,gist,62644,18512,26464495872
46,25,2,23,0,standard,standard,61579,19754,330724339540
46,25,2,23,0,standard,gist,68247,18589,26458192104
47,275,240,35,0,gist,standard,80933,45142,3674080410040
47,275,240,35,0,gist,gist,75964,40263,3206470209920
48,38,8,30,0,gist,standard,63404,20094,502960362772
48,38,8,30,0,gist,gist,62891,19059,105886602352
49,46,13,33,0,standard,standard,60842,20444,609040014436
49,46,13,33,0,standard,gist,69893,19410,172120195078
50,41,13,28,0,gist,standard,61230,20457,542732352436
50,41,13,28,0,gist,gist,63186,19548,172086049668
51,155,134,21,0,gist,standard,64124,32787,2061074597800
51,155,134,21,0,gist,gist,65180,33285,1781832269008
52,19,2,17,0,gist,standard,64521,19359,251290676152
52,19,2,17,0,gist,gist,63935,18377,26451888336
53,40,9,31,0,gist,standard,64303,20057,529473971920
53,40,9,31,0,gist,gist,64482,19258,119131850018
54,34,8,26,0,gist,standard,66495,19886,449945752012
54,34,8,26,0,gist,gist,63842,19033,105869792304
55,45,19,26,0,gist,standard,67429,20620,595776380780
55,45,19,26,0,gist,gist,61789,20241,251550181268
56,32,9,23,0,standard,standard,61131,19960,423444750400
56,32,9,23,0,standard,gist,69595,19031,119094027410
57,272,238,34,0,standard,standard,73941,44954,3633570879520
57,272,238,34,0,standard,gist,76569,38615,3179374552860
58,180,163,17,0,standard,standard,62474,33450,2395869854600
58,180,163,17,0,standard,gist,65153,34159,2169593282366
59,43,25,18,0,standard,standard,60691,20528,569252265352
59,43,25,18,0,standard,gist,68740,20475,330960730840
60,28,9,19,0,standard,standard,59028,19831,370455354712
60,28,9,19,0,standard,gist,64600,19080,119075116106
61,26,16,10,0,standard,standard,60623,19494,343966960636
61,26,16,10,0,standard,gist,70111,19757,211672078176
62,26,7,19,0,gist,standard,65954,19652,343966960636
62,26,7,19,0,gist,gist,62235,18824,92606683962
63,84,66,18,0,standard,standard,60924,26972,1113836608712
63,84,66,18,0,standard,gist,69329,24962,875157392468
64,37,16,21,0,standard,standard,61405,20204,489705134140
64,37,16,21,0,standard,gist,70660,19981,211764533440
65,47,9,38,0,gist,standard,66902,18795,622304698720
65,47,9,38,0,gist,gist,62130,19440,119164944800
66,129,79,50,0,standard,standard,60445,26332,1713584097092
66,129,79,50,0,standard,gist,69234,22328,1049404317692
67,437,373,64,0,gist,standard,89057,59605,5875636701340
67,437,373,64,0,gist,gist,94846,53447,5015131594140
68,31,15,16,0,standard,standard,59686,20091,410195825536
68,31,15,16,0,standard,gist,64965,19446,198481988480
69,23,2,21,0,gist,standard,59591,19462,304242249232
69,23,2,21,0,gist,gist,63828,18331,26456090848
70,36,16,20,0,gist,standard,66913,19998,476450956136
70,36,16,20,0,gist,gist,63977,19748,211756128416
71,101,81,20,0,standard,standard,58994,27756,1340157832636
71,101,81,20,0,standard,gist,71111,25637,1074780096716
72,24,2,22,0,standard,standard,60634,19404,317482769072
72,24,2,22,0,standard,gist,68097,18365,26457141476
73,32,11,21,0,gist,standard,67069,19916,423444750400
73,32,11,21,0,gist,gist,64114,19110,145559307670
74,68,43,25,0,gist,standard,64769,24182,901105763752
74,68,43,25,0,gist,gist,63693,21354,569816977902
75,58,41,17,0,gist,standard,65255,20416,768285567292
75,58,41,17,0,gist,gist,64491,21187,543098496294
76,45,28,17,0,gist,standard,65265,20570,595776380780
76,45,28,17,0,gist,gist,63670,20876,370705404176
77,51,2,49,0,standard,standard,61241,20406,675373942136
77,51,2,49,0,standard,gist,68917,18767,26485508432
78,23,7,16,0,standard,standard,59607,19478,304242249232
78,23,7,16,0,standard,gist,69546,18840,92595652368
79,63,40,23,0,standard,standard,60822,20743,834682532672
79,63,40,23,0,standard,gist,68524,21075,529957260800
80,27,2,25,0,gist,standard,67637,19887,357210632360
80,27,2,25,0,gist,gist,63938,18414,26460293360
81,50,29,21,0,gist,standard,65348,20364,662105055340
81,50,29,21,0,gist,gist,63156,20793,384021043918
82,170,131,39,0,standard,standard,62104,34179,2261872954780
82,170,131,39,0,standard,gist,70166,33313,1742972749762
83,48,8,40,0,standard,standard,60801,20368,635570433632
83,48,8,40,0,standard,gist,69094,19067,105928627472
84,26,6,20,0,standard,standard,66183,19517,343966960636
84,26,6,20,0,standard,gist,66998,18721,79377195716
85,94,25,69,0,standard,standard,60730,27432,1246929968452
85,94,25,69,0,standard,gist,70207,20724,331630506190
86,20,2,18,0,gist,standard,65883,19255,264526993480
86,20,2,18,0,gist,gist,65936,18369,26452938964
87,59,10,49,0,gist,standard,64389,20706,781562859112
87,59,10,49,0,gist,gist,69893,19548,132468502320
88,119,95,24,0,gist,standard,66427,28270,1580123017552
88,119,95,24,0,gist,gist,64776,28798,1261442798800
89,17,2,15,0,standard,standard,60718,19304,224821193380
89,17,2,15,0,standard,gist,68002,18443,26449787080
90,27,2,25,0,standard,standard,61043,19893,357210632360
90,27,2,25,0,standard,gist,66041,18375,26460293360
91,24,8,16,0,gist,standard,66831,19405,317482769072
91,24,8,16,0,gist,gist,62652,18979,105827767184
92,45,27,18,0,gist,standard,65385,20589,595776380780
92,45,27,18,0,gist,gist,63874,20757,357465934964
93,460,441,19,0,gist,standard,92277,62591,6190438546360
93,460,441,19,0,gist,gist,89249,60444,5934746530442
94,70,45,25,0,gist,standard,65967,24289,927682410580
94,70,45,25,0,gist,gist,63275,21480,596367359030
95,66,7,59,0,standard,standard,60835,24194,874533319436
95,66,7,59,0,standard,gist,69704,19084,92753771882
96,317,224,93,0,gist,standard,76187,47670,4242206680780
96,317,224,93,0,gist,gist,74277,40088,2997647701120
97,41,26,15,0,standard,standard,61225,20483,542732352436
97,41,26,15,0,standard,gist,63420,20484,344171833096
98,58,36,22,0,standard,standard,62191,20464,768285567292
98,58,36,22,0,standard,gist,64990,19036,476867004824
99,68,53,15,0,standard,standard,59056,20897,901105763752
99,68,53,15,0,standard,gist,65275,21221,702332492242
100,88,35,53,0,standard,standard,60104,26969,1167061345072
100,88,35,53,0,standard,gist,65394,20965,464172286230
101,22,9,13,0,gist,standard,64333,19168,291002780020
101,22,9,13,0,gist,gist,62410,19101,119046749150
102,31,9,22,0,standard,standard,61129,20114,410195825536
102,31,9,22,0,standard,gist,69574,19143,119089299584
103,24,2,22,0,gist,standard,65125,19403,317482769072
103,24,2,22,0,gist,gist,64109,18353,26457141476
104,306,281,25,0,gist,standard,79872,46738,4093232573036
104,306,281,25,0,gist,gist,79312,47260,3758818168886
105,72,31,41,0,standard,standard,61472,24143,954263259920
105,72,31,41,0,standard,gist,64999,20940,410863499630
106,35,9,26,0,standard,standard,61179,20141,463197828760
106,35,9,26,0,standard,gist,69030,19247,119108210888
107,55,26,29,0,gist,standard,66896,20702,728459995600
107,55,26,29,0,gist,gist,64289,20676,344363047392
108,31,12,19,0,standard,standard,60027,20122,410195825536
108,31,12,19,0,standard,gist,69798,19250,158785644032
109,29,9,20,0,standard,standard,61198,20079,383701127692
109,29,9,20,0,standard,gist,68613,19085,119079843932
110,19,2,17,0,standard,standard,64308,19360,251290676152
110,19,2,17,0,standard,gist,70107,18438,26451888336
111,112,62,50,0,standard,standard,59520,27822,1486762774240
111,112,62,50,0,standard,gist,70235,21583,823029511740
112,315,286,29,0,gist,standard,76436,47594,4215111023720
112,315,286,29,0,gist,gist,80885,48355,3827053207952
113,39,22,17,0,gist,standard,66361,20279,516216642032
113,39,22,17,0,gist,gist,61847,20154,291199247456
114,35,8,27,0,gist,standard,66705,20192,463197828760
114,35,8,27,0,gist,gist,63464,19231,105873994816
115,35,7,28,0,gist,standard,67251,20341,463197828760
115,35,7,28,0,gist,gist,64590,19080,92639778744
116,30,12,18,0,gist,standard,66829,20085,396947951300
116,30,12,18,0,gist,gist,62388,19218,158779340264
117,33,13,20,0,standard,standard,61136,20237,436694725892
117,33,13,20,0,standard,gist,69105,19453,172031417012
118,24,9,15,0,gist,standard,66431,19430,317482769072
118,24,9,15,0,gist,gist,62732,19122,119056204802
119,84,34,50,0,gist,standard,65712,27010,1113836608712
119,84,34,50,0,gist,gist,64741,21097,450838785812
120,19,2,17,0,gist,standard,65922,19350,251290676152
120,19,2,17,0,gist,gist,61978,18455,26451888336
121,87,74,13,0,gist,standard,65090,27453,1153753585040
121,87,74,13,0,gist,gist,64696,25519,981353663840
122,291,274,17,0,standard,standard,75000,46890,3890290934936
122,291,274,17,0,standard,gist,80090,45162,3663023095184
123,27,13,14,0,standard,standard,60206,19911,357210632360
123,27,13,14,0,standard,gist,65029,19301,171990442520
124,55,23,32,0,standard,standard,61730,20714,728459995600
124,55,23,32,0,standard,gist,67807,20437,304628880336
125,31,13,18,0,standard,standard,61685,20155,410195825536
125,31,13,18,0,standard,gist,70555,19306,172017758848
126,46,14,32,0,gist,standard,66698,20474,609040014436
126,46,14,32,0,gist,gist,63908,19506,185360189604
127,21,2,19,0,gist,standard,66321,19422,277764361436
127,21,2,19,0,gist,gist,64115,18446,26453989592
128,56,2,54,0,standard,standard,60037,20475,741734135536
128,56,2,54,0,standard,gist,68512,18569,26490761572
129,50,14,36,0,gist,standard,63875,20370,662105055340
129,50,14,36,0,gist,gist,64463,19532,185389607188
130,53,15,38,0,standard,standard,61117,20443,701914867612
130,53,15,38,0,standard,gist,69919,19767,198655342100
131,29,10,19,0,standard,standard,59743,18419,383701127692
131,29,10,19,0,standard,gist,69208,19027,132310908120
132,83,58,25,0,standard,standard,66632,27235,1100533051192
132,83,58,25,0,standard,gist,69183,21593,769047272592
133,32,2,30,0,standard,standard,65026,19935,423444750400
133,32,2,30,0,standard,gist,69087,18404,26465546500
134,34,8,26,0,gist,standard,65981,19892,449945752012
134,34,8,26,0,gist,gist,63175,19038,105869792304
135,50,30,20,0,standard,standard,61005,20377,662105055340
135,50,30,20,0,standard,gist,69255,20771,397263139700
136,35,8,27,0,gist,standard,65772,20170,463197828760
136,35,8,27,0,gist,gist,62620,19213,105873994816
137,182,160,22,0,gist,standard,70363,33411,2422681842100
137,182,160,22,0,gist,gist,65525,33930,2129830223040
138,31,2,29,0,standard,standard,60179,20122,410195825536
138,31,2,29,0,standard,gist,69820,18530,26464495872
139,35,12,23,0,gist,standard,64491,20162,463197828760
139,35,12,23,0,gist,gist,64377,19408,158810859104
140,32,17,15,0,gist,standard,66211,20015,423444750400
140,32,17,15,0,gist,gist,63712,19959,224955148450
141,73,2,71,0,standard,standard,60408,24655,967555260532
141,73,2,71,0,standard,gist,69175,18902,26508622248
142,28,8,20,0,standard,standard,60999,19845,370455354712
142,28,8,20,0,standard,gist,66994,18923,105844577232
143,25,2,23,0,standard,standard,61174,19761,330724339540
143,25,2,23,0,standard,gist,68819,18357,26458192104
144,46,2,44,0,standard,standard,61019,20501,609040014436
144,46,2,44,0,standard,gist,67193,18593,26480255292
145,68,45,23,0,standard,standard,60702,24144,901105763752
145,68,45,23,0,standard,gist,70436,21406,596320080770
146,26,9,17,0,gist,standard,65088,19513,343966960636
146,26,9,17,0,gist,gist,62795,19098,119065660454
147,32,2,30,0,gist,standard,60068,19940,423444750400
147,32,2,30,0,gist,gist,64017,18426,26465546500
148,68,43,25,0,standard,standard,61203,24193,901105763752
148,68,43,25,0,standard,gist,70401,21372,569816977902
149,56,18,38,0,standard,standard,60324,20533,741734135536
149,56,18,38,0,standard,gist,67164,20059,238414724228
150,194,159,35,0,gist,standard,66613,39366,2583642019852
150,194,159,35,0,gist,gist,66115,34076,2117521084922
151,60,2,58,0,standard,standard,61464,20518,794841201560
151,60,2,58,0,standard,gist,69443,18760,26494964084
152,34,20,14,0,standard,standard,61212,19889,449945752012
152,34,20,14,0,standard,gist,62392,19860,264674081400
153,31,6,25,0,standard,standard,61516,20106,410195825536
153,31,6,25,0,standard,gist,69712,18776,79392955136
154,47,24,23,0,gist,standard,64996,20700,622304698720
154,47,24,23,0,gist,gist,64228,20561,317772742400
155,43,10,33,0,standard,standard,61030,20553,569252265352
155,43,10,33,0,standard,gist,70453,19395,132384452080
156,41,23,18,0,gist,standard,66761,20469,542732352436
156,41,23,18,0,gist,gist,63632,20317,304459729228
157,61,23,38,0,gist,standard,65754,20705,808120594636
157,61,23,38,0,gist,gist,62580,20506,304701373668
158,59,9,50,0,standard,standard,65745,20759,781562859112
158,59,9,50,0,standard,gist,69585,19468,119221678712
159,23,6,17,0,gist,standard,68176,19470,304242249232
159,23,6,17,0,gist,gist,64423,18768,79367740064
160,201,186,15,0,standard,standard,65985,39891,2677605323636
160,201,186,15,0,standard,gist,66585,33889,2477784050696
161,77,30,47,0,gist,standard,67997,24606,1020733769260
161,77,30,47,0,gist,gist,64556,21238,397688644040
162,81,18,63,0,gist,standard,66295,24681,1073929088036
162,81,18,63,0,gist,gist,63040,20471,238651115528
163,39,18,21,0,gist,standard,61747,20246,516216642032
163,39,18,21,0,gist,gist,63696,20090,238253978144
164,105,80,25,0,standard,standard,60412,23051,1393454011700
164,105,80,25,0,standard,gist,70745,25614,1061679310400
165,29,7,22,0,gist,standard,62177,20029,383701127692
165,29,7,22,0,gist,gist,64399,18892,92617715556
166,31,9,22,0,standard,standard,60342,20124,410195825536
166,31,9,22,0,standard,gist,70150,19150,119089299584
167,34,13,21,0,standard,standard,61167,19898,449945752012
167,34,13,21,0,standard,gist,68035,19293,172038246094
168,30,10,20,0,standard,standard,62231,19894,396947951300
168,30,10,20,0,standard,gist,70271,19122,132316161260
169,18,7,11,0,gist,standard,67100,19211,238055409452
169,18,7,11,0,gist,gist,62297,18756,92577266378
170,134,110,24,0,gist,standard,65445,32074,1780354035412
170,134,110,24,0,gist,gist,64399,29046,1461484703620
171,24,2,22,0,standard,standard,60797,19407,317482769072
171,24,2,22,0,standard,gist,71873,18347,26457141476
172,20,2,18,0,gist,standard,65547,19085,264526993480
172,20,2,18,0,gist,gist,61810,18435,26452938964
173,87,38,49,0,standard,standard,60454,27346,1153753585040
173,87,38,49,0,standard,gist,69572,21317,503938497440
174,19,2,17,0,gist,standard,65878,19347,251290676152
174,19,2,17,0,gist,gist,64696,18378,26451888336
175,25,2,23,0,standard,standard,59311,19612,330724339540
175,25,2,23,0,standard,gist,71974,18337,26458192104
176,63,28,35,0,gist,standard,62078,20730,834682532672
176,63,28,35,0,gist,gist,63333,21008,370970162432
177,161,128,33,0,standard,standard,61688,32879,2141365573636
177,161,128,33,0,standard,gist,71033,29782,1702452187648
178,48,14,34,0,gist,standard,61669,20312,635570433632
178,48,14,34,0,gist,gist,62933,19462,185374898396
179,185,67,118,0,standard,standard,63844,33560,2462907703060
179,185,67,118,0,standard,gist,64629,26018,891972148764
180,23,2,21,0,standard,standard,64866,19456,304242249232
180,23,2,21,0,standard,gist,71145,18413,26456090848
181,19,2,17,0,standard,standard,59226,19343,251290676152
181,19,2,17,0,standard,gist,70578,18439,26451888336
182,31,2,29,0,gist,standard,68445,20068,410195825536
182,31,2,29,0,gist,gist,65127,18480,26464495872
183,100,85,15,0,gist,standard,67415,27483,1326836414440
183,100,85,15,0,gist,gist,65497,27947,1127810992210
184,51,33,18,0,standard,standard,61369,20351,675373942136
184,51,33,18,0,standard,gist,70327,20948,437006762408
185,165,137,28,0,gist,standard,67045,33099,2194913903420
185,165,137,28,0,gist,gist,65597,33575,1822443710444
186,53,32,21,0,gist,standard,68335,20478,701914867612
186,53,32,21,0,gist,gist,63003,21059,423797761408
187,270,249,21,0,gist,standard,80106,45715,3606569778980
187,270,249,21,0,gist,gist,76354,39150,3326058816878
188,59,42,17,0,gist,standard,61760,20657,781562859112
188,59,42,17,0,gist,gist,62944,21329,556366857776
189,76,44,32,0,standard,standard,61555,24232,1007437566136
189,76,44,32,0,standard,gist,67697,21458,583253439864
190,169,133,36,0,standard,standard,62254,34237,2248479043252
190,169,133,36,0,standard,gist,70827,33371,1769513149924
191,30,8,22,0,gist,standard,67185,19892,396947951300
191,30,8,22,0,gist,gist,62388,19049,105852982256
192,28,10,18,0,gist,standard,63968,19837,370455354712
192,28,10,18,0,gist,gist,64562,19150,132305654980
193,34,15,19,0,gist,standard,65529,19924,449945752012
193,34,15,19,0,gist,gist,64375,19400,198505627610
194,24,7,17,0,standard,standard,58987,19441,317482769072
194,24,7,17,0,standard,gist,72762,18865,92599329566
195,35,9,26,0,standard,standard,61450,20280,463197828760
195,35,9,26,0,standard,gist,69973,19268,119108210888
196,62,43,19,0,gist,standard,66578,18297,821401038340
196,62,43,19,0,gist,gist,64344,19590,569681446890
197,39,8,31,0,gist,standard,63421,20269,516216642032
197,39,8,31,0,gist,gist,63616,17034,105890804864
198,25,10,15,0,gist,standard,67252,19628,330724339540
198,25,10,15,0,gist,gist,64440,19199,132289895560
199,145,128,17,0,gist,standard,66434,32604,1927340354980
199,145,128,17,0,gist,gist,64006,29675,1701376344576
200,100,57,43,0,gist,standard,65494,27481,1326836414440
200,100,57,43,0,gist,gist,64845,21665,756296870714
201,39,12,27,0,standard,standard,60099,20310,516216642032
201,39,12,27,0,standard,gist,69924,19387,158836074176
202,23,8,15,0,standard,standard,60871,19465,304242249232
202,23,8,15,0,standard,gist,67297,19041,105823564672
203,22,2,20,0,gist,standard,66782,19175,291002780020
203,22,2,20,0,gist,gist,69968,18393,26455040220
204,137,56,81,0,gist,standard,67256,32405,1820428605940
204,137,56,81,0,gist,gist,64291,22015,744116959840
205,31,2,29,0,standard,standard,62247,20098,410195825536
205,31,2,29,0,standard,gist,70169,18441,26464495872
206,117,62,55,0,standard,standard,59649,28133,1553443409180
206,117,62,55,0,standard,gist,70169,21961,823192359080
207,108,92,16,0,gist,standard,65495,27623,1433437177592
207,108,92,16,0,gist,gist,63975,28068,1221076153688
208,81,53,28,0,standard,standard,60003,24671,1073929088036
208,81,53,28,0,standard,gist,69169,21362,702694433588
209,27,2,25,0,standard,standard,61423,19885,357210632360
209,27,2,25,0,standard,gist,67979,18348,26460293360
210,24,7,17,0,gist,standard,66117,19438,317482769072
210,24,7,17,0,gist,gist,64256,18689,92599329566
211,28,14,14,0,gist,standard,66535,19826,370455354712
211,28,14,14,0,gist,gist,62883,19320,185227810476
212,99,59,40,0,gist,standard,65497,27690,1313516046872
212,99,59,40,0,gist,gist,64704,21663,782802600152
213,46,7,39,0,standard,standard,61718,20505,609040014436
213,46,7,39,0,standard,gist,70415,18947,92680227922
214,59,43,16,0,gist,standard,67545,20663,781562859112
214,59,43,16,0,gist,gist,62824,21415,569613681384
215,40,12,28,0,standard,standard,61224,20093,529473971920
215,40,12,28,0,standard,gist,69633,19281,158842377944
216,21,2,19,0,standard,standard,61101,19290,277764361436
216,21,2,19,0,standard,gist,69233,18376,26453989592
217,49,21,28,0,gist,standard,62062,20543,648837219172
217,49,21,28,0,gist,gist,61931,20266,278073246068
218,31,11,20,0,gist,standard,66739,20117,410195825536
218,31,11,20,0,gist,gist,64535,19168,145553529216
219,34,9,25,0,gist,standard,66120,19904,449945752012
219,34,9,25,0,gist,gist,64808,19103,119103483062
220,76,58,18,0,gist,standard,60940,24410,1007437566136
220,76,58,18,0,gist,gist,64823,21361,768833995108
221,71,34,37,0,gist,standard,65836,24441,940972309936
221,71,34,37,0,gist,gist,64819,21117,450606597024
222,71,39,32,0,standard,standard,60974,24461,940972309936
222,71,39,32,0,standard,gist,70185,21208,516872233904
223,29,12,17,0,standard,standard,61626,20048,383701127692
223,29,12,17,0,standard,gist,69931,19249,158773036496
224,22,2,20,0,standard,standard,59256,19190,291002780020
224,22,2,20,0,standard,gist,65058,18375,26455040220
225,26,8,18,0,standard,standard,60958,19493,343966960636
225,26,8,18,0,standard,gist,67762,19035,105836172208
226,107,57,50,0,gist,standard,61828,27820,1420108405000
226,107,57,50,0,gist,gist,65261,21784,756506471000
227,106,84,22,0,standard,standard,59953,27595,1406780683036
227,106,84,22,0,standard,gist,66712,27933,1114807388984
228,189,170,19,0,gist,standard,69751,33844,2516556893132
228,189,170,19,0,gist,gist,70260,35394,2263569719000
229,292,275,17,0,gist,standard,75642,46044,3903813023080
229,292,275,17,0,gist,gist,81470,47276,3676536252990
230,30,13,17,0,gist,standard,59990,17875,396947951300
230,30,13,17,0,gist,gist,64905,18461,172010929766
231,44,20,24,0,gist,standard,62253,20435,582513797752
231,44,20,24,0,gist,gist,65274,19898,264779144200
232,36,9,27,0,gist,standard,61945,19995,476450956136
232,36,9,27,0,gist,gist,63590,19114,119112938714
233,184,151,33,0,standard,standard,64081,32935,2449498032112
233,184,151,33,0,standard,gist,65325,33311,2010185932798
234,29,10,19,0,standard,standard,61388,20024,383701127692
234,29,10,19,0,standard,gist,69438,19149,132310908120
235,116,2,114,0,gist,standard,61621,27831,1540105180936
235,116,2,114,0,gist,gist,63423,18912,26553799252
236,44,16,28,0,standard,standard,61304,20397,582513797752
236,44,16,28,0,standard,gist,70795,19863,211823368608
237,33,14,19,0,standard,standard,59671,20057,436694725892
237,33,14,19,0,standard,gist,65147,19520,185264582456
238,18,2,16,0,gist,standard,64090,19361,238055409452
238,18,2,16,0,gist,gist,64444,18354,26450837708
239,39,15,24,0,standard,standard,61472,20281,516216642032
239,39,15,24,0,standard,gist,70692,19594,198545026160
240,48,28,20,0,gist,standard,64533,20365,635570433632
240,48,28,20,0,gist,gist,63109,20649,370749530552
241,35,25,10,0,gist,standard,66109,20120,463197828760
241,35,25,10,0,gist,gist,64448,20479,330855668040
242,353,333,20,0,gist,standard,78736,49477,4730647137412
242,353,333,20,0,gist,gist,82040,50229,4462621818932
243,146,113,33,0,standard,standard,61690,32381,1940709051436
243,146,113,33,0,standard,gist,69909,29315,1502055695878
244,93,9,84,0,standard,standard,58583,27476,1233615904652
244,93,9,84,0,standard,gist,71127,19745,119382424796
245,46,32,14,0,gist,standard,66206,20486,609040014436
245,46,32,14,0,gist,gist,64709,20773,423680091072
246,56,26,30,0,standard,standard,61946,20529,741734135536
246,56,26,30,0,standard,gist,69531,20413,344376705556
247,24,7,17,0,gist,standard,66114,19424,317482769072
247,24,7,17,0,gist,gist,63237,18733,92599329566
248,84,64,20,0,gist,standard,65733,26995,1113836608712
248,84,64,20,0,gist,gist,64919,21508,848637479552
249,36,13,23,0,gist,standard,67848,19980,476450956136
249,36,13,23,0,gist,gist,64725,19266,172051904258
250,39,12,27,0,standard,standard,61601,20415,516216642032
250,39,12,27,0,standard,gist,68885,19400,158836074176
251,24,9,15,0,standard,standard,60865,19424,317482769072
251,24,9,15,0,standard,gist,70002,18963,119056204802
